rows 112
cols 112
players 7
m ............................%%%....................%%%.....%%%%........................0...%%%.............%%%%.
m ...........................%%%%....................%%%%....%%%.............................%%%.............%%%..
m ............................%%%....................%%%%....%%%.............................%%%.............%%%%.
m ...........................%%%%....................%%%%....%%%..............................%%..............%%..
m ...%%%%%%%%%%%%%%%%%%%%%%%%%%%%............%..%....%%%%....%%%%.....%%.....%.%%....%%.%%...%%%.....%...%%%%%%%%.
m ...%%%%%%%%%%%%%%%%%%%%%%%%%%%.....%%%%....%%%%....%%%.....%%%%.....%%%....%%%.....%%%%%%%%%%%%.....%%%%%%%%%%..
m ....%%%%%%%%%%%%%%%%%%%%%%%%%%%....%%%%....%%%%.....%%%....%%%......%%.....%%%.....%%%%%%%%%%%.....%%%%%%%%%%%..
m ...%.%.%%%.%.....%%%%%%...%%%%.....%%%.....%%%%3....%%%.....%.......%%......%%%........%%..%%......%%%%.%%.%%...
m ..................3.%%..............%%%....%%%.....%%%.............%%%%............................%%%..........
m ...................%%%%.............%%%....%%%%....%%%%.............%%%............................%%%..........
m ...................%%%.............%%%%....%%%%.....%%..............%%%............................%%%%.........
m ...................%%%.............%%%%....%%%%.....%%..............%%.............................%%%..........
m %%.%%.%....%%.......%%.....%........%%%%%%%%%%%....%%%%....%%%......%%......%..%%%...%%......%%%%%%%%%%%%.....%.
m %%%%%%......%%%.....%%%....%%%%....%%%%%%%%%%%.....%%%%....%%%%.....%%.....%%%%%%%%%%%%.....%%%%%%%%%%%%%%%%%%%%
m %%%%%%......%%%.....%%%.....%%%.....%%%%%%%%%%%.....%%%....%%%.....%%%.....%%%%%%%%%%%......%%%%%%%%%%%%%%%%%%%%
m %..%.%%....%%%%.....%%%.....%.......%%%%%..%%%%....%.......%%%.....%%%%....%%%%...%%%%......%%%...%%%...%%%%%%%.
m ...........%%%%.............................%%%....................%%%.....%%%%........................5...%%%..
m ...........%%%.............................%%%%....................%%%%....%%%.............................%%%..
m ...........%%%%.............................%%%....................%%%%....%%%.............................%%%..
m ............%%.............................%%%%....................%%%%....%%%..............................%%..
m ...%...%%%%%%%%....%%%%%%%%%%%%%%%%%%%%%%%%%%%%............%..%....%%%%....%%%%.....%%.....%.%%....%%.%%...%%%..
m ....%%%%%%%%%%.....%%%%%%%%%%%%%%%%%%%%%%%%%%%.....%%%%....%%%%....%%%.....%%%%.....%%%....%%%.....%%%%%%%%%%%%.
m ...%%%%%%%%%%%......%%%%%%%%%%%%%%%%%%%%%%%%%%%....%%%%....%%%%.....%%%....%%%......%%.....%%%.....%%%%%%%%%%%..
m ...%%%%.%%.%%......%.%.%%%.%.....%%%%%%...%%%%.....%%%.....%%%%1....%%%.....%.......%%......%%%........%%..%%...
m ...%%%............................1.%%..............%%%....%%%.....%%%.............%%%%.........................
m ...%%%.............................%%%%.............%%%....%%%%....%%%%.............%%%.........................
m ...%%%%............................%%%.............%%%%....%%%%.....%%..............%%%.........................
m ...%%%.............................%%%.............%%%%....%%%%.....%%..............%%..........................
m %%%%%%%%%.....%.%%.%%.%....%%.......%%.....%........%%%%%%%%%%%....%%%%....%%%......%%......%..%%%...%%......%%%
m %%%%%%%%%%%%%%%%%%%%%%......%%%.....%%%....%%%%....%%%%%%%%%%%.....%%%%....%%%%.....%%.....%%%%%%%%%%%%.....%%%%
m %%%%%%%%%%%%%%%%%%%%%%......%%%.....%%%.....%%%.....%%%%%%%%%%%.....%%%....%%%.....%%%.....%%%%%%%%%%%......%%%%
m ..%%%...%%%%%%%.%..%.%%....%%%%.....%%%.....%.......%%%%%..%%%%....%.......%%%.....%%%%....%%%%...%%%%......%%%.
m .......3...%%%.............%%%%.............................%%%....................%%%.....%%%%.................
m ...........%%%.............%%%.............................%%%%....................%%%%....%%%..................
m ...........%%%.............%%%%.............................%%%....................%%%%....%%%..................
m ............%%..............%%.............................%%%%....................%%%%....%%%..................
m ...%%.%%...%%%.....%...%%%%%%%%....%%%%%%%%%%%%%%%%%%%%%%%%%%%%............%..%....%%%%....%%%%.....%%.....%.%%.
m ...%%%%%%%%%%%%.....%%%%%%%%%%.....%%%%%%%%%%%%%%%%%%%%%%%%%%%.....%%%%....%%%%....%%%.....%%%%.....%%%....%%%..
m ...%%%%%%%%%%%.....%%%%%%%%%%%......%%%%%%%%%%%%%%%%%%%%%%%%%%%....%%%%....%%%%.....%%%....%%%......%%.....%%%..
m .......%%..%%......%%%%.%%.%%......%.%.%%%.%.....%%%%%%...%%%%.....%%%.....%%%%6....%%%.....%.......%%......%%%.
m ...................%%%............................6.%%..............%%%....%%%.....%%%.............%%%%.........
m ...................%%%.............................%%%%.............%%%....%%%%....%%%%.............%%%.........
m ...................%%%%............................%%%.............%%%%....%%%%.....%%..............%%%.........
m ...................%%%.............................%%%.............%%%%....%%%%.....%%..............%%..........
m %%...%%......%%%%%%%%%%%%.....%.%%.%%.%....%%.......%%.....%........%%%%%%%%%%%....%%%%....%%%......%%......%..%
m %%%%%%%.....%%%%%%%%%%%%%%%%%%%%%%%%%%......%%%.....%%%....%%%%....%%%%%%%%%%%.....%%%%....%%%%.....%%.....%%%%%
m %%%%%%......%%%%%%%%%%%%%%%%%%%%%%%%%%......%%%.....%%%.....%%%.....%%%%%%%%%%%.....%%%....%%%.....%%%.....%%%%%
m ..%%%%......%%%...%%%...%%%%%%%.%..%.%%....%%%%.....%%%.....%.......%%%%%..%%%%....%.......%%%.....%%%%....%%%%.
m .......................1...%%%.............%%%%.............................%%%....................%%%.....%%%%.
m ...........................%%%.............%%%.............................%%%%....................%%%%....%%%..
m ...........................%%%.............%%%%.............................%%%....................%%%%....%%%..
m ............................%%..............%%.............................%%%%....................%%%%....%%%..
m ....%%.....%.%%....%%.%%...%%%.....%...%%%%%%%%....%%%%%%%%%%%%%%%%%%%%%%%%%%%%............%..%....%%%%....%%%%.
m ....%%%....%%%.....%%%%%%%%%%%%.....%%%%%%%%%%.....%%%%%%%%%%%%%%%%%%%%%%%%%%%.....%%%%....%%%%....%%%.....%%%%.
m ....%%.....%%%.....%%%%%%%%%%%.....%%%%%%%%%%%......%%%%%%%%%%%%%%%%%%%%%%%%%%%....%%%%....%%%%.....%%%....%%%..
m ....%%......%%%........%%..%%......%%%%.%%.%%......%.%.%%%.%.....%%%%%%...%%%%.....%%%.....%%%%4....%%%.....%...
m ...%%%%............................%%%............................4.%%..............%%%....%%%.....%%%..........
m ....%%%............................%%%.............................%%%%.............%%%....%%%%....%%%%.........
m ....%%%............................%%%%............................%%%.............%%%%....%%%%.....%%..........
m ....%%.............................%%%.............................%%%.............%%%%....%%%%.....%%..........
m ....%%......%..%%%...%%......%%%%%%%%%%%%.....%.%%.%%.%....%%.......%%.....%........%%%%%%%%%%%....%%%%....%%%..
m ....%%.....%%%%%%%%%%%%.....%%%%%%%%%%%%%%%%%%%%%%%%%%......%%%.....%%%....%%%%....%%%%%%%%%%%.....%%%%....%%%%.
m ...%%%.....%%%%%%%%%%%......%%%%%%%%%%%%%%%%%%%%%%%%%%......%%%.....%%%.....%%%.....%%%%%%%%%%%.....%%%....%%%..
m ...%%%%....%%%%...%%%%......%%%...%%%...%%%%%%%.%..%.%%....%%%%.....%%%.....%.......%%%%%..%%%%....%.......%%%..
m ...%%%.....%%%%........................6...%%%.............%%%%.............................%%%.................
m ...%%%%....%%%.............................%%%.............%%%.............................%%%%.................
m ...%%%%....%%%.............................%%%.............%%%%.............................%%%.................
m ...%%%%....%%%..............................%%..............%%.............................%%%%.................
m ...%%%%....%%%%.....%%.....%.%%....%%.%%...%%%.....%...%%%%%%%%....%%%%%%%%%%%%%%%%%%%%%%%%%%%%............%..%.
m ...%%%.....%%%%.....%%%....%%%.....%%%%%%%%%%%%.....%%%%%%%%%%.....%%%%%%%%%%%%%%%%%%%%%%%%%%%.....%%%%....%%%%.
m ....%%%....%%%......%%.....%%%.....%%%%%%%%%%%.....%%%%%%%%%%%......%%%%%%%%%%%%%%%%%%%%%%%%%%%....%%%%....%%%%.
m ....%%%.....%.......%%......%%%........%%..%%......%%%%.%%.%%......%.%.%%%.%.....%%%%%%...%%%%.....%%%.....%%%%2
m ...%%%.............%%%%............................%%%............................2.%%..............%%%....%%%..
m ...%%%%.............%%%............................%%%.............................%%%%.............%%%....%%%%.
m ....%%..............%%%............................%%%%............................%%%.............%%%%....%%%%.
m ....%%..............%%.............................%%%.............................%%%.............%%%%....%%%%.
m ...%%%%....%%%......%%......%..%%%...%%......%%%%%%%%%%%%.....%.%%.%%.%....%%.......%%.....%........%%%%%%%%%%%.
m ...%%%%....%%%%.....%%.....%%%%%%%%%%%%.....%%%%%%%%%%%%%%%%%%%%%%%%%%......%%%.....%%%....%%%%....%%%%%%%%%%%..
m ....%%%....%%%.....%%%.....%%%%%%%%%%%......%%%%%%%%%%%%%%%%%%%%%%%%%%......%%%.....%%%.....%%%.....%%%%%%%%%%%.
m ...%.......%%%.....%%%%....%%%%...%%%%......%%%...%%%...%%%%%%%.%..%.%%....%%%%.....%%%.....%.......%%%%%..%%%%.
m ...................%%%.....%%%%........................4...%%%.............%%%%.............................%%%.
m ...................%%%%....%%%.............................%%%.............%%%.............................%%%%.
m ...................%%%%....%%%.............................%%%.............%%%%.............................%%%.
m ...................%%%%....%%%..............................%%..............%%.............................%%%%.
m ...........%..%....%%%%....%%%%.....%%.....%.%%....%%.%%...%%%.....%...%%%%%%%%....%%%%%%%%%%%%%%%%%%%%%%%%%%%%.
m ...%%%%....%%%%....%%%.....%%%%.....%%%....%%%.....%%%%%%%%%%%%.....%%%%%%%%%%.....%%%%%%%%%%%%%%%%%%%%%%%%%%%..
m ...%%%%....%%%%.....%%%....%%%......%%.....%%%.....%%%%%%%%%%%.....%%%%%%%%%%%......%%%%%%%%%%%%%%%%%%%%%%%%%%%.
m ...%%%.....%%%%0....%%%.....%.......%%......%%%........%%..%%......%%%%.%%.%%......%.%.%%%.%.....%%%%%%...%%%%..
m ....%%%....%%%.....%%%.............%%%%............................%%%............................0.%%..........
m ....%%%....%%%%....%%%%.............%%%............................%%%.............................%%%%.........
m ...%%%%....%%%%.....%%..............%%%............................%%%%............................%%%..........
m ...%%%%....%%%%.....%%..............%%.............................%%%.............................%%%..........
m ....%%%%%%%%%%%....%%%%....%%%......%%......%..%%%...%%......%%%%%%%%%%%%.....%.%%.%%.%....%%.......%%.....%....
m ...%%%%%%%%%%%.....%%%%....%%%%.....%%.....%%%%%%%%%%%%.....%%%%%%%%%%%%%%%%%%%%%%%%%%......%%%.....%%%....%%%%.
m ....%%%%%%%%%%%.....%%%....%%%.....%%%.....%%%%%%%%%%%......%%%%%%%%%%%%%%%%%%%%%%%%%%......%%%.....%%%.....%%%.
m ....%%%%%..%%%%....%.......%%%.....%%%%....%%%%...%%%%......%%%...%%%...%%%%%%%.%..%.%%....%%%%.....%%%.....%...
m ............%%%....................%%%.....%%%%........................2...%%%.............%%%%.................
m ...........%%%%....................%%%%....%%%.............................%%%.............%%%..................
m ............%%%....................%%%%....%%%.............................%%%.............%%%%.................
m ...........%%%%....................%%%%....%%%..............................%%..............%%..................
m %%%%%%%%%%%%%%%............%..%....%%%%....%%%%.....%%.....%.%%....%%.%%...%%%.....%...%%%%%%%%....%%%%%%%%%%%%%
m %%%%%%%%%%%%%%.....%%%%....%%%%....%%%.....%%%%.....%%%....%%%.....%%%%%%%%%%%%.....%%%%%%%%%%.....%%%%%%%%%%%%%
m %%%%%%%%%%%%%%%....%%%%....%%%%.....%%%....%%%......%%.....%%%.....%%%%%%%%%%%.....%%%%%%%%%%%......%%%%%%%%%%%%
m .%%%%%%...%%%%.....%%%.....%%%%5....%%%.....%.......%%......%%%........%%..%%......%%%%.%%.%%......%.%.%%%.%....
m ..5.%%..............%%%....%%%.....%%%.............%%%%............................%%%..........................
m ...%%%%.............%%%....%%%%....%%%%.............%%%............................%%%..........................
m ...%%%.............%%%%....%%%%.....%%..............%%%............................%%%%.........................
m ...%%%.............%%%%....%%%%.....%%..............%%.............................%%%..........................
m ....%%.....%........%%%%%%%%%%%....%%%%....%%%......%%......%..%%%...%%......%%%%%%%%%%%%.....%.%%.%%.%....%%...
m ....%%%....%%%%....%%%%%%%%%%%.....%%%%....%%%%.....%%.....%%%%%%%%%%%%.....%%%%%%%%%%%%%%%%%%%%%%%%%%......%%%.
m ....%%%.....%%%.....%%%%%%%%%%%.....%%%....%%%.....%%%.....%%%%%%%%%%%......%%%%%%%%%%%%%%%%%%%%%%%%%%......%%%.
m ....%%%.....%.......%%%%%..%%%%....%.......%%%.....%%%%....%%%%...%%%%......%%%...%%%...%%%%%%%.%..%.%%....%%%%.
